%%%%%%%%%%%%%%
%            %
% %%%%%%%%%% %
% %    P     %
% % %%%%%%%%%%
%.%          %
%%%%%%%%%%%% %
%            %
%%% %%%%%%%%%%
%            %
%%%%%%%%%%%%%%
