%%%%%%%%%%%%%%%%%%%
%P                %
%                 %
%                 %
%                 %
%                 %
%                 %
%                 %
%                 %
%                 %
%                 %
%                 %
%        %%%%%%%%%%
%                .%
%%%%%%%%%%%%%%%%%%%
